9,12,0.home,1,0,0,-1
0,0,0,0,0,0,0,0,0,0,0,0,0,0,0,0,0,0,0,0
0,-8,-3,-3,-3,-3,-3,-3,-3,-3,-3,-3,-3,-3,-3,-4,-6,-3,-9,0
0,-8,-12,1,-12,-2,1,1,1,-13,1,1,1,1,1,-5,-7,-1,-9,0
0,-8,1,1,1,-2,1,1,1,1,1,1,1,1,1,1,1,1,-9,0
0,-8,-2,-2,-2,-2,1,1,1,1,1,1,1,1,1,1,1,1,-9,0
0,-8,1,1,1,1,1,1,1,1,1,1,1,1,1,1,1,1,-9,0
0,-8,1,1,1,1,1,1,1,1,1,1,1,1,1,1,1,1,-9,0
0,-8,1,1,1,1,1,1,1,1,1,1,1,1,1,1,1,1,-9,0
0,-8,1,1,1,1,1,1,1,1,1,1,1,-1,1,1,1,1,-9,0
0,-8,1,1,1,-1,1,1,1,1,1,1,1,1,1,1,1,1,-9,0
0,-8,1,1,1,1,1,1,1,1,1,1,1,1,1,-2,1,1,-9,0
0,-8,1,1,1,1,1,1,1,1,1,1,1,1,1,1,1,1,-9,0
0,-8,1,1,1,1,1,1,1,1,1,1,1,1,1,1,1,1,-9,0
0,-8,-3,-3,-3,-3,-3,-3,-3,11,10,-3,-3,-3,-3,-3,-3,-3,-9,0
0,0,0,0,0,0,0,0,0,0,0,0,0,0,0,0,0,0,0,0
EOM
7,3,3,1,ERROR
7,5,9,3,てきによってジョブのあいしょうがあるからへんせいにはきをつけよう！
7,17,2,2,うけれないクエストはほかのクエストをたっせいするとうけられるようになるよ！
7,13,8,4,クエスト50をクリアするといけるようになるダンジョンがあるらしい...
5,9,13,たに,gake.1.csv,8,28,みずうみ,lake.1.csv,33,28,やかた,hall.1.csv,35,58,まち,town.1.csv,1,45,うみ,sea.1.csv,33,58,とう,tower.1.csv,33,58,もり,forest.1.csv,1,20,ラスト,last.1.csv,8,28
5,10,13,たに,gake.1.csv,8,28,みずうみ,lake.1.csv,33,28,やかた,hall.1.csv,35,58,まち,town.1.csv,1,45,うみ,sea.1.csv,33,58,とう,tower.1.csv,33,58,もり,forest.1.csv,1,21,ラスト,last.1.csv,8,28
1,15,2
1,16,2
2,3,4
6,15,10
8,9,2